30,20
@@@@@@@@@@@@@@@@@@@@@@@@@@@@@@
@......................@.....@
@............................@
@..........................@@@
@........................@@@@@
@......................@@@@@@@
@...-------..--..-...--@@@@@@@
@..-...................@@@@@@@
@.-....................@@@@@@@
@-...........................@
@.-..........................@
@@@@...@..@@..@@@@@-----=----@
@@@@...@..@@..@@@@@.....#....@
@.......................#....@
@.......................#....@
@.......................#....@
@@..........@@@@@@@@@@@-=-@@@@
@.........@@@@@@@@@@@...#...@@
@..&....@@@@@@@@@@@@@...#...@@
@@@@@@@@@@@@@@@@@@@@@@@@@@@@@@